"TileType(0: nonBlock,1: block, 2:monster, 3:trap, 4:player, 5:npc, 6: key, 7:map)  ",,,,,,,,
,,,,,,,,
0,0,0,0,0,0,0,0,0
0,0,0,0,0,7,7,0,0
0,0,7,7,2,7,7,0,0
0,0,7,2,7,2,0,0,0
0,7,7,0,0,0,0,0,0
0,7,1,7,7,1,7,0,0
0,7,1,7,1,7,7,5,0
0,0,0,0,0,0,0,0,0
