"TileType(0: nonBlock,1: block, 2:monster, 3:trap, 4:player, 5:npc, 6: key, 7:map)  ",0,1,2,3,4,5,6,7
0,0,0,0,0,0,0,0,0
1,0,0,0,0,0,1,1,0
2,0,0,1,1,1,1,1,0
3,0,0,1,1,1,1,0,0
4,0,1,1,0,0,0,0,0
5,0,1,1,1,1,1,1,0
6,0,1,1,1,1,1,1,0
7,0,0,0,0,0,0,0,0
